{
  "terrainGrid": [
    [3, 3, 3, 3, 3, 3, 3, 3, 3, 3, 3, 3, 3, 3, 3, 3, 3, 3, 3, 3, 3, 3, 3, 3, 3, 3, 3, 3, 3, 3, 3, 3, 3, 3, 3, 3],
      [3, 3, 3, 3, 3, 3, 3, 3, 3, 3, 3, 3, 3, 3, 3, 3, 3, 3, 3, 3, 3, 3, 3, 3, 3, 3, 3, 3, 3, 3, 3, 3, 3, 3, 3, 3],
    [3, 3, 3, 3, 3, 3, 3, 3, 3, 3, 3, 3, 3, 3, 3, 6, 6, 6, 6, 6, 3, 3, 3, 6, 6, 6, 3, 3, 3, 3, 3, 3, 3, 3, 3, 2],
      [3, 3, 3, 3, 6, 6, 6, 6, 3, 3, 6, 6, 6, 6, 6, 1, 1, 1, 1, 6, 6, 6, 6, 1, 1, 6, 6, 6, 6, 3, 3, 3, 6, 6, 2, 2],
    [6, 6, 6, 6, 6, 1, 1, 1, 6, 6, 6, 1, 1, 2, 1, 1, 1, 1, 1, 2, 2, 1, 1, 1, 1, 1, 1, 1, 1, 6, 6, 6, 6, 1, 1, 2],
      [2, 1, 1, 1, 4, 1, 1, 1, 1, 1, 1, 1, 1, 1, 1, 1, 1, 1, 1, 1, 1, 1, 1, 2, 1, 1, 1, 1, 1, 1, 1, 4, 1, 1, 1, 2],
    [2, 1, 1, 1, 1, 4, 1, 1, 1, 1, 1, 1, 1, 1, 1, 1, 2, 1, 1, 1, 1, 1, 1, 1, 1, 1, 1, 1, 1, 1, 1, 4, 1, 1, 1, 2],
      [2, 2, 2, 1, 1, 4, 1, 1, 2, 2, 1, 1, 2, 1, 1, 1, 1, 1, 1, 1, 1, 1, 1, 1, 1, 1, 1, 2, 1, 1, 1, 4, 1, 1, 1, 2],
    [2, 1, 1, 1, 1, 5, 1, 1, 1, 2, 1, 1, 1, 1, 1, 1, 1, 1, 2, 1, 1, 1, 1, 1, 1, 1, 1, 1, 1, 1, 1, 4, 1, 1, 1, 2],
      [2, 1, 1, 1, 4, 1, 1, 1, 1, 1, 1, 1, 1, 1, 1, 1, 1, 1, 1, 1, 1, 1, 1, 1, 2, 1, 1, 1, 1, 1, 1, 5, 1, 1, 2, 2],
    [2, 1, 1, 1, 1, 4, 1, 1, 1, 1, 1, 1, 1, 1, 1, 1, 1, 1, 1, 1, 1, 1, 1, 1, 1, 2, 1, 1, 1, 1, 1, 1, 1, 1, 1, 2],
      [2, 1, 1, 1, 1, 1, 1, 1, 1, 1, 1, 1, 2, 1, 1, 2, 1, 1, 1, 1, 1, 1, 1, 1, 2, 2, 1, 1, 1, 1, 1, 1, 1, 1, 1, 2],
    [2, 1, 1, 1, 1, 2, 2, 1, 1, 1, 1, 1, 1, 1, 1, 1, 1, 2, 1, 1, 1, 1, 1, 1, 1, 1, 1, 1, 2, 2, 1, 1, 1, 1, 1, 2],
      [2, 1, 1, 1, 1, 1, 1, 1, 1, 1, 1, 1, 1, 1, 1, 1, 1, 1, 1, 1, 2, 1, 1, 1, 1, 1, 1, 1, 1, 1, 1, 1, 2, 1, 1, 2],
    [0, 0, 0, 0, 0, 0, 0, 0, 0, 0, 0, 0, 0, 0, 0, 0, 0, 0, 0, 0, 0, 0, 0, 0, 0, 0, 0, 0, 0, 0, 0, 0, 0, 0, 0, 0]
  ],
  "colonies": [
    {
      "eggs": [
      ],
      "ants": [
        {"location": [5, 8], "facing": 5, "cast": "Larva",   "numberOfAnts": 1, "foodHeld": 0},
        {"location": [5, 8], "facing": 6, "cast": "Queen",   "numberOfAnts": 1, "foodHeld": 0}
      ],
      "foodSupply": 25,
      "antColor": "#000000"
    },
    {
      "eggs": [],
      "ants": [
        {"location": [31, 9], "facing": 0, "cast": "Larva",   "numberOfAnts": 1, "foodHeld": 0},
        {"location": [31, 9], "facing": 1, "cast": "Queen",   "numberOfAnts": 1, "foodHeld": 0}
      ],
      "foodSupply": 25,
      "antColor": "#750D06"
    }
  ],
  "foodItems": [
    {"appearance": "BasicParticle", "location": [ 5,  6], "foodValue": 14},
    {"appearance": "BasicParticle", "location": [31,  7], "foodValue": 14},
    {"appearance": "BasicParticle", "location": [ 8,  4], "foodValue": 18},
    {"appearance": "BasicParticle", "location": [26,  3], "foodValue": 18},
    {"appearance": "BasicParticle", "location": [17,  2], "foodValue": 20},
    {"appearance": "BasicParticle", "location": [ 3, 11], "foodValue": 12},
    {"appearance": "BasicParticle", "location": [30, 12], "foodValue": 12}
  ]
}
